 - - - - - - - - - - 
|         |         |
   -   -       - -   
|   |     | |       |
       - - -         
|     |         |   |
 - -       - - - -   
| |     |   |       |
       -             
|   |       | |     |
 - - - - -       -   
|         |     |   |
 - - - - - - - - - - 
0,0
5,5
