 - - - - - - - - 
|   |       |   |
       - -       
| |     |     | |
       - - -     
|   |   | |     |
           - -   
|   |       | | |
                 
|   |   |     | |
   - - -       
|     |       | |
 - - - - - - - - 
|   |           |
       - - -     
|           |   |
 - - - - - - - - 
0,0
4,3
